****************************
*............**............*
*.****.*****.**.*****.****.*
*.****.*****....*****.****.*
*.****.*****.**.*****.****.*
*............**............*
*.****.**.********.**.****.*
*.****.**.********.**.****.*
*......**....**....**......*
***.**.*****.**.*****.**.***
***.**.*****.**.*****.**.***
*...**................**...*
*.****.**.###  ###.**.****.*
*.****.**.#      #.**.****.*
*......**.# %%%% #.**......*
*.****.**.#      #.**.****.*
*.****.**.########.**.****.*
*...**.**..........**.**...*
***.**.**.********.**.**.***
***.**.**.********.**.**.***
*.............@............*
*.****.*****.**.*****.****.*
*.****.*****.**.*****.****.*
*...**.......**.......**...*
***.**.**.********.**.**.***
***.**.**.********.**.**.***
*......**....**....**......*
*.****.*****.**.*****.****.*
*.****.*****.**.*****.****.*
*..........................*
****************************
