+--------------------------+
|............**............|
|.****.*****.**.*****.****.|
|.****.*****....*****.****.|
|.****.*****.**.*****.****.|
|............**............|
|.****.**.********.**.****.|
|.****.**.********.**.****.|
|......**....**....**......|
|**.**.*****.**.*****.**.**|
|**.**.*****.**.*****.**.**|
|...**................**...|
|.****.**.##    ##.**.****.|
|.****.**.#      #.**.****.|
=......**.# %%%% #.**......=
|.****.**.#      #.**.****.|
|.****.**.########.**.****.|
|...**.**..........**.**...|
|**.**.**.********.**.**.**|
|**.**.**.********.**.**.**|
|.............@............|
|.****.*****.**.*****.****.|
|.****.*****.**.*****.****.|
|...**.......**.......**...|
|**.**.**.********.**.**.**|
|**.**.**.********.**.**.**|
|......**....**....**......|
|.****.*****.**.*****.****.|
|.****.*****.**.*****.****.|
|..........................|
+--------------------------+
